LES MOTS ğŸ“–

- MÃ©taphysique : RÃ©flexion rationnelle sur les idÃ©es transcendantales
- Ontologie : Sous-domaine de la mÃ©taphysique qui sâ€™intÃ©resse a lâ€™essence de lâ€™Ãªtre
- Ã‰vanescent : Qui sâ€™amoindrit et disparaÃ®t graduellement
- InnocuitÃ© : Quelque chose qui nâ€™est pas nocif, inoffensif
- Anachronique : Qui nâ€™est pas dans son Ã©poque, dâ€™un autre Ã¢ge
- Erratique : Du latin Â«Â vagabondÂ Â», instable, irrÃ©gulier
- Laudatif : Ã‰logieux
- IdÃ©alisme : Le rÃ©el nâ€™est quâ€™une reprÃ©sentation de lâ€™esprit
- RÃ©alisme : Le rÃ©el existe indÃ©pendamment de lâ€™esprit
- MatÃ©rialisme : La matiÃ¨re lâ€™emporte sur lâ€™esprit
- Spiritualisme : Lâ€™esprit lâ€™emporte sur la matiÃ¨re
- Monisme : UnicitÃ© de lâ€™Ãªtre, esprit et matiÃ¨re indissociables
- Dualisme : Existence de deux principes dissociÃ©s et indÃ©pendants (par exemple esprit et matiÃ¨re)
- Pluralisme : Existe plusieurs principes dissociÃ©s et indÃ©pendants
- Idiosyncrasie : PersonnalitÃ© psychique propre dâ€™un individu
- Scientisme : Position philosophique consistant Ã  considÃ©rer que lâ€™approche scientifique est la seule Ã  pouvoir mener Ã  la connaissance et Ã  la rÃ©solution de problÃ¨mes philosophiques (Le positivisme est un type de scientisme)
- Monade : En mÃ©taphysique Ã§a signifie UnitÃ© maximale, le Tout global, mais qui Ã  lâ€™autre bout est aussi le Tout minimal, le plus petit Ã©lÃ©ment spirituel
- Ersatz : Ce qui remplace quelque chose sans le valoir
- Marquis de Sade : Auteur du XVIII siÃ¨cle, accordant une place importante Ã  lâ€™Ã©rotisme et Ã  la cruautÃ© dans ses livres (origine du mot sadique)
- Dissension : DÃ©saccord profond
- Surfait : Sur-cÃ´tÃ©
- HellÃ©nisme : Civilisation grecque antique dans son ensemble
- Anomie : Absence dâ€™organisation ou de loi, disparition de valeur communes Ã  un groupe
- Doxa : Ensemble des opinions reÃ§ues comme Ã©videntes dans une civilisation donnÃ©e
- Contingent : Qui peut se produire ou nom, accidentel, Ã©ventuel
- DÃ©lÃ©tÃ¨re : Qui met la santÃ© en danger, nuisible
- Ã‰tiage : Le plus bas niveau dâ€™un cours dâ€™eau
- Å’cumÃ©nisme : Mouvement promouvant le dialogue entre les diffÃ©rentes branches du christianisme
- Estivage : Migration des troupeaux vers la montagne en Ã©tÃ©
- Tautologie : Le fait de redire la mÃªme chose Â«Â vu de mes yeux vuÂ Â», vrai par essence Â«Â aussi vrai que mon pÃ¨re est mon pÃ¨reÂ Â»
- Roboratif : Qui revigore, redonne des forces
- Ã‰pistÃ©mologie : Ã‰tude des sciences et de la connaissance au sens large
- Religions rÃ©vÃ©lÃ©es : Christianisme, judaÃ¯sme, islam
- AscÃ¨se : Privation voulue et hÃ©roÃ¯que
- HÃ©donisme : Philosophie cherchant le plaisir et Ã©vitant la souffrance
- Poncif : Autrefois esquisse dessinÃ© vouÃ©e Ã  Ãªtre reproduite, maintenant veut simplement dire quelque chose de vu et revu
- Pontifier : Dispenser sa science avec prÃ©tention et emphase
- PanthÃ©isme : Doctrine philosophique selon laquelle Dieu est Tout (plantes, arbres, chats, casserolesâ€¦) en opposition au monothÃ©isme ou polythÃ©iste ou le ou les dieux sont distincts du monde
- Collusion : entente secrÃ¨te au prÃ©judice dâ€™un tiers
- Cyclothymique : Maladie mentale faisant alterner entre phase maniaque et phase dÃ©pressive 
- Insipide : Qui nâ€™a aucune saveur, aucun goÃ»t
- En deÃ§Ã  : En-dessous de
- Sanctifier : Rendre saint
- Torpide : Qui provoque la torpeur
- Torpeur : Du latin torpere, Ãªtre engourdi
- TutÃ©laire : Qui assure une protection, avoir la tutelle de
- Ã‰quinoxe : Chacune des deux pÃ©riodes de lâ€™annÃ©e oÃ¹ la nuit est aussi longue que le jour
- Tropisme : RÃ©action dâ€™orientation ou de locomotion causÃ© par des agents physiques ou chimiques, en rÃ©sumÃ© un rÃ©flexe.
- Placide : Doux et calme
- Lascif : TrÃ¨s sensuel
- LisiÃ¨re : Partie extrÃªme dâ€™une surface, (la lisiÃ¨re du bois, avant dâ€™entrer sur la plaine)
- Entregent : HabilitÃ© Ã  la vie sociale
- Anthropologie : Ã‰tude de lâ€™humain, on y retrouve diverses spÃ©cialisations comme lâ€™ethnologie, la linguistiqueâ€¦
- Anthropomorphisme : Tendance Ã  attribuer aux animaux, aux choses (etc.) des caractÃ¨res et rÃ©actions humaines (Anthropo = Ãªtre humain / Morphe = Forme)
- Psychologisme : Tendance Ã  tout expliquer par la psychologie. Ã‡a peut aboutir Ã  un relativisme gÃ©nÃ©ral, il nâ€™y a plus de jugement faux ou vrais, il nâ€™y a que des opinions propre Ã  chaque individu en fonction de leur psychÃ© 
- Poussif : Qui respire difficilement, manque de souffle
- Surnager : Subsister, se maintenir parmi ce qui disparaÃ®t, garder la tÃªte hors de lâ€™eau
- Terminologie : Ã‰tude du choix et de lâ€™usage des termes faisant partie des vocabulaires de spÃ©cialitÃ© (Table fait partie de la terminologie de lâ€™ameublement et de lâ€™informatique)
- Fortuit : Qui arrive par hasard
- DÃ©mocrate : Grande famille idÃ©ologique voulant donner le pouvoir au peuple. Les applications de cette idÃ©e varient et on retrouve en son sein les libÃ©raux et les rÃ©publicains
- Hypertrophie : DÃ©veloppement excessif, anormal
- Particules Ã©lÃ©mentaires : Ce sont les plus petits objets physique qui constituent la matiÃ¨re (atomes, Ã©lectrons, quarks, en fonction de lâ€™expÃ©rience)
- Ãˆre victorienne : Ãˆre de la reine Victoria, marquant lâ€™apogÃ©e de la rÃ©volution industrielle aux UK
- Indicible : Quâ€™on ne peut dire, inexprimable
- Impie : Quelque chose qui insulte la religion, blasphÃ©matoire
- SyncrÃ©tisme : MÃ©lange dâ€™influence
- Ã‰sotÃ©rique : Qui se transmet seulement Ã  des adeptes qualifiÃ©s
- Bas-relief : Ouvrage de sculpture en faible saillie sur fond uni
- Haut-relief : Ouvrage de sculpture en forte saillie sur fond uni
- Architecture cyclopÃ©enne : Architecture primitive consistant Ã  entasser des pierres grossiÃ¨rement pour former un mur, un barrage etcâ€¦
- Monolithe : Bloc de pierre massif constituÃ© dâ€™un seul Ã©lÃ©ment
- Limon : MÃ©lange de terre et de dÃ©bris organique quâ€™on trouve au fond des Ã©tangs
- Levantin : Habitant du Moyen-Orient (de lÃ  oÃ¹ le soleil se lÃ¨ve)
- Squameux : Ã‰cailleux 
- IrisÃ© : Qui a les nuances de lâ€™arc en ciel
- Iridescent : Qui a des reflets irisÃ©s 
- MÃ©lopÃ©e : MÃ©lodie monotone et mÃ©lancolique 
- Polype : Excroissance dâ€™une muqueuse
- Orgiaque : Qui tient de lâ€™orgie
- Euclide : MathÃ©maticien de -300 ayant thÃ©orisÃ© la gÃ©omÃ©trie
- GÃ©omÃ©trie non-euclidienne : GÃ©omÃ©trie remettant en cause le 5Ã¨me axiome dâ€™Euclide Â«Â 2 droites parallÃ¨les ne se touchent jamaisÂ Â»
- Concave : Surface arrondi vers lâ€™intÃ©rieur
- Convexe : Surface arrondi vers lâ€™extÃ©rieur
- Caracoler : Chevaucher en faisant cambrer le cheval
- Aporie : DifficultÃ© logique insoluble
- Philosophie de lâ€™histoire : Courant philosophique affirmant que lâ€™histoire nâ€™est pas le produit du chaos ou du hasard, mais est bel et bien une suite dâ€™Ã©vÃ©nement logique tendant vers un but
- MatÃ©rialisme historique : Philosophie de lâ€™histoire arguant que lâ€™histoire est dÃ©terminÃ©e par les rapports entre les diffÃ©rentes classes sociales (par ce quâ€™on vit et pas par ce quâ€™on pense dâ€™oÃ¹ Â«Â matÃ©rialisteÂ Â»)
- Transcendant : Qui est au-delÃ  de toutes expÃ©riences possibles (ex. un ordre de rÃ©alitÃ© supÃ©rieur)
- Immanent : Qui est situÃ© dans les limites de lâ€™expÃ©rience possible
- Technocratie : Courant politique privilÃ©giant la technique Ã  lâ€™humain dans la mise en Å“uvre de mesure politique
- Chantre : Quelquâ€™un qui cÃ©lÃ¨bre quelque chose
- AnÃ©mie : Manque dâ€™hÃ©moglobine, fatigue chronique, manque de force
- Panglossien : Optimiste de maniÃ¨re naÃ¯ve ou irraisonnÃ©
- Caustique : BrÃ»le les tissus animaux et vÃ©gÃ©taux, acide
- ChrÃ©matistique : Gestion et nÃ©gociation des affaires dâ€™argent (terme fondÃ© par Aristote)
- Impassible : Qui nâ€™Ã©prouve ou ne trahit aucune Ã©motion
- Impavide : Qui nâ€™Ã©prouve ou ne trahit aucune crainte
- HÃ©donisme : Du grec HÃ©donÃ© (plaisir), doctrine philosophique selon laquelle le plaisir est le bien suprÃªme et quâ€™une vie sage consiste Ã  le maximiser
- Primat : CaractÃ¨re prÃ©Ã©minent (Le primat du cÅ“ur sur la raison)
- TÃ©lÃ©ologie : Philosophie arguant que chaque chose a une fin, un but. Et que ce but peut-Ãªtre Ã©tudiÃ©.
- MÃ©canisme : Philosophie arguant que les phÃ©nomÃ¨nes ne sont quâ€™un lien de causes Ã  effet, et quâ€™il nâ€™y aucun but. Il revient donc plutÃ´t dâ€™Ã©tudier le mouvement.
- Tory : Aux UK, membre du parti conservateur
- PropÃ©deutique : Connaissance prÃ©parant Ã  une Ã©tude plus approfondie
- Ibidem : AbrÃ©viation Â«Â IbidÂ Â», citation issu du mÃªme ouvrage ou passage dÃ©jÃ  citÃ©
- Sempiternel : Continuel et lassant
- Existentialisme : Doctrine philosophique disant que les actions ont un rÃ´le sur le destin, en opposition au dÃ©terminisme
- ExÃ©gÃ¨se : InterprÃ©tation dâ€™un texte dont le sens est obscur
- ObÃ©dience : ObÃ©issance a une puissance spirituelle
- Scabreux : Embarrassant, dÃ©licat
- Ã‰lucubration: ThÃ©orie laborieuse et peu sensÃ©e
- PrÃ©dicat : Ce qui dans un Ã©noncÃ© est affirmÃ© Ã  propos dâ€™un autre terme (Les cygnes sont blancs, cygnes = sujet, sont blancs = prÃ©dicat)
- AurifÃ¨re : Qui contient de lâ€™or
- EndogÃ¨ne : Qui prend naissance Ã  lâ€™intÃ©rieur, vient de lâ€™intÃ©rieur
- ExogÃ¨ne : Qui prend naissance Ã  lâ€™extÃ©rieur, vient de lâ€™extÃ©rieur
- Algarade : Attaque brusque en parole
- Vicissitudes : Les Ã©vÃ¨nements heureux et malheureux qui se succÃ¨dent et composent la vie
- Cordite : Poudre explosive Ã  base de nitroglycÃ©rine utilisÃ©e dans les munitions
- Ã‰thique : Science de la Morale
- AffectÃ© : Qui manque de sincÃ©ritÃ© ou de naturel
- Badaud : Un passant flÃ¢neur
- Ã‰pigramme : Trait dâ€™esprit satirique contre quelquâ€™un
- AnachorÃ¨te: Religieux contemplatif qui se retire dans la solitude
- SuccÃ©danÃ© : Un produit qui peut en remplacer un autre (câ€™est le penchant neutre de Â«Â ersatzÂ Â»)
- Sphinge : Penchant fÃ©minin du Sphinx
- Marasme : Ã‰tat pathologique dÃ» Ã  un apport nutritif insuffisant
- HÃ©raut : Au Moyen-Ã‚ge câ€™Ã©tait un messager
- Idoine : Qui convient parfaitement, appropriÃ©, adÃ©quat
- Ergastule : Dans lâ€™antiquitÃ© romaine, prison, cachot
- GÃ©henne : Torture, souffrance intolÃ©rable (vient de la Bible)
- Axillaire : En anatomie, qui a rapport a lâ€™aisselle
- Exsangue : Qui a perdu beaucoup de sang, trÃ¨s pÃ¢le
- JachÃ¨re : Lorsque lâ€™on laisse une terre labourable se reposer
- VÃ©tuste : Qui nâ€™est plus en bon Ã©tat Ã  cause de lâ€™usure du temps
- Scorie : RÃ©sidus issues du traitement Ã  haute tempÃ©rature de certains mÃ©taux
- VÃ©niel : Faute digne de pardon, opposÃ© Ã  pÃ©chÃ© mortel
- InanitÃ© : CaractÃ¨re de ce qui est vain
- Malingre : Qui est dâ€™une constitution faible
- Pusillanime: Qui manque dâ€™audace
- Philologie : Ã‰tude des langues
- GynÃ©cÃ©e : Dans lâ€™AntiquitÃ©, câ€™Ã©tait lâ€™appartement rÃ©servÃ© aux femmes au sein dâ€™une maison
- Borborygme : Bruit produit par le dÃ©placement des gaz dans lâ€™estomac (gargouillement)
- Tribulation : Tourment moral considÃ©rÃ© comme une Ã©preuve
- Litote : Figure de rÃ©thorique consistant Ã  attÃ©nuer lâ€™expression de se pensÃ©e (ce nâ€™est pas mauvais pour câ€™est pas bon)
- Litanie : PriÃ¨re oÃ¹ toutes les invocations sont suivies dâ€™une formule (RÃ©pÃ©titif, ennuyeuxâ€¦)
- Onomastique : Ã‰tude des noms propre
- Hardeur : Acteur de film X
- Arcadie : Terre pastorale idyllique et harmonieuse
- Ignominie : CaractÃ¨re de ce qui dÃ©shonore
- Prophylactique : Qui prÃ©vient la maladie
- Atavisme : HÃ©rÃ©ditÃ© des caractÃ¨res physiques et psychologiques
- SaynÃ¨te : Courte piÃ¨ce comique avec peu de personnages
- Pugilat : Bagarre Ã  coups de poings
- Babillement : Lâ€™expression de sons inarticulÃ©s dâ€™un nourrisson 
- PatÃ¨re : PiÃ¨ce fixÃ© au mur servant Ã  suspendre les vÃªtements
- Ã‰tole : Large bande de tissu portÃ© autour du cou ou des Ã©paules
- TrÃ©pigner : Frapper des pieds contre terre Ã  plusieurs reprises sous le coup de lâ€™Ã©motion
- GuÃ©ridon : Petite table souvent ronde
- Pugnace : Qui aime combattre
- Grivois : Qui est dâ€™une gaietÃ© licencieuse
- Licencieux : Qui manque de pudeur, de dÃ©cence
- Aquilin : Se dit dâ€™un trait physique comparable Ã  lâ€™aigle
- Indigence : Grande pauvretÃ©, manque du nÃ©cessaire
- Contigu : Qui se touche (deux chambres voisines = deux chambres contiguÃ«s)
- Diaphane : Translucide
- VespÃ©rale : Du soir (des pensÃ©es vespÃ©rales)
- Tacite : Qui nâ€™est pas formellement expliquÃ©, qui est sous-entendu
- Connivence : Entente secrÃ¨te, accord tacite
- Fantasque : Sujet Ã  des fantaisies
- Transi : Engourdi de froid ou dâ€™un sentiment qui paralyse
- Volubile : Qui parle avec abondance, rapiditÃ©
- Interstice : TrÃ¨s petit espace vide entre deux objets
- Putrescible : Qui peut se putrÃ©fier
- Bravache : Faux brave, fanfaron
- Ã‰tioler : Rendre quelque chose chÃ©tif et pÃ¢le (Donc nuire Ã  la fois Ã  son teint et Ã  sa tenue)
- Lancinant : Qui se manifeste par des Ã©lancements aigus (Au figurÃ© : obsÃ©dant)
- Souverainisme : PrÃ©servation de la souverainetÃ© nationale dâ€™un pays au sein dâ€™une instance supranationale (comme lâ€™Europe)
- Chassie : Crotte des yeux
- DuÃ¨gne : Vieille dame chargÃ©e de veiller sur la conduite dâ€™une jeune
- MoirÃ© : Qui a un aspect changeant
- Duplice : Fourbe, hypocrite, qui fait preuve de duplicitÃ©
- Lambris : Assemblage de panneaux de bois utilisÃ© pour dÃ©corer un intÃ©rieur
- DÃ©bonnaire : Dâ€™une bontÃ© extrÃªme, un peu faible
- Ire : ColÃ¨re
- Colifichet : Petit objet de fantaisie, sans grande valeur
- Ã‰maciÃ© : TrÃ¨s amaigri
- Raboteux : InÃ©gal, rempli de creux et de bosses (un chemin raboteux)
- Quolibet : Propos moqueur Ã  lâ€™adresse de quelquâ€™un
- Stipendier : Payer quelquâ€™un pour accomplir une basse besogne
- OpiniÃ¢tre : ObstinÃ©, voir entÃªtÃ©, dans ses idÃ©es et son comportement
- PÃ©ripatÃ©ticien : Disciple dâ€™Aristote (Aristote faisait ses cours en marchant), donc par extension, quelquâ€™un qui fait les 100 pas
- PÃ©ripatÃ©ticienne : Dans le jargon de la prostitution, on appelle comme Ã§a une pute qui racolle en marchant, comparÃ© Ã  une Â«Â grueÂ Â» qui elle est stationnaire
- Ratiociner : Se perdre dans raisonnements subtils et interminables
- Ã‰phÃ©mÃ©ride : Calendrier Ã  effeuiller
- LinolÃ©um : RevÃªtement de sol constituÃ© de polyester enduit dâ€™huile de lin de rÃ©signe et de liÃ¨ge en poudre
- Baladum : RevÃªtement de sol constiutÃ© de carton enduit dâ€™asphalte (moins cher que le LinolÃ©um)
- Laconique : Qui sâ€™exprime en peu de mots
- Viatique : Provision (nourriture ou argent) donnÃ© pour un Voyage. Chez les catholique, Ã§a reprÃ©sente la communion portÃ©e Ã  un mourant (en vue de son dernier voyage)
- Onanisme : Se faire Ã©jaculer sans partenaire (masturbation)
- Diurne : Qui se produit le jour (opposÃ© Ã  nocture)
- MÃ©tonymie : Exprime une rÃ©alitÃ©, en utilisant le nom dâ€™une autre rÃ©alitÃ© Ã©tant liÃ©e Ã  la premiÃ¨re, par glissement de sens. Ex : Parler du contenant pour le contenu (boire un verre), lâ€™instrument pour lâ€™agent (Câ€™est une bonne plume)
- Ã‰mail : MatiÃ¨re fondante, composÃ© de diffÃ©rents minÃ©raux, utilisÃ© surtout pour orner des bijoux
- Ã‰maillÃ© : Qui est recouvert dâ€™Ã©mail. UtilisÃ© aussi pour parler de qqch qui contient des dÃ©tails remarquables
- Orner : Mettre en valeur qqch, par des ajouts dÃ©coratifs
- Feston : De lâ€™italien festone Â«Â Ornement de fÃªteÂ Â» (en gÃ©nÃ©ral des branches, des fleurs, des fruits)
- LÃ©nifiant : Apaisant, qui endort la vigilance
- FatuitÃ© : Satisfaction de soi-mÃªme, Ã©talÃ©e dâ€™une maniÃ¨re desagrÃ©able
- Galvauder : DÃ©tÃ©riorer quelque chose par un mauvais usage
- Marotte : GoÃ»t obsessionnel pour quelque chose
- Spasmodique : CaractÃ©risÃ©e par le spasme
- Kyrielle : Suite ininterrompue, sÃ©rie interminable
- EngoncÃ© : Lorsquâ€™un habit donne lâ€™impression que la tÃªte est enfoncÃ©e dans les Ã©paules
- Cloaque : Lieu destinÃ© Ã  recevoir les immondices, les eaux usÃ©es
- SÃ©raphique : Qui Ã©voque les SÃ©raphins (type dâ€™ange) et du coup leur suavitÃ©, leur puretÃ©â€¦
- Fustiger : Battre Ã  coup de bÃ¢ton, blÃ¢mer violemment
- Ataraxie : Apaisement de lâ€™Ã¢me
- Capiton : Division crÃ©Ã©e par la piqure dâ€™un tissu (effet rembourrage)
- Escarbille : Fragment de bois ou de charbon sâ€™Ã©chappant dâ€™un foyer de feu
- LÃ©thÃ© : Fleuve des enfers oÃ¹ lâ€™on boit pour oublier le passÃ© (mythologie grecque)
- Ahaner : Respirer bruyamment
- LivrÃ©e : Uniforme de serviteur
- Baudrier : Ensemble de sangles enserrant le haut des cuisses et la taille
- Expectorer : Rejeter hors des voies respiratoires (cracher / tousser)
- Sanatorium : Maison de santÃ© oÃ¹ lâ€™on traite la tuberculose
- Porte Ã  tambour : Porte tourniquet
- Faire chambrer : Amener le vin Ã  la tempÃ©rature de la piÃ¨ce
- Calendes grecques : Les grecques, nâ€™ayant jamais eu de calendes, cela permet de parler dâ€™une date qui nâ€™arrivera jamais (ironie)
- Stuc : Enduit fait de marbre blanc utilisÃ© pour dÃ©corer ou imiter le marbre
- Jabot : Ornement de dentelle attachÃ© au col et sâ€™Ã©talant sur la poitrine
- Rococo : Mouvement artistique du XVIII, prolongement de lâ€™art baroque
- Palissandre : EspÃ¨ce de bois tropical
- Redingote : Manteau ajustÃ© Ã  la taille
- DaguerrÃ©otype: Ancien procÃ©dÃ© photographique fixant lâ€™image sur une plaque dâ€™argent
- Erratique : Qui nâ€™est pas fixe
- Oblong : Qui est plus long que large
- Pelisse : Manteau doublÃ© ou garni dâ€™une fourrure
- Batiste : Fine toile de lin ou de coton
- Catafalque : Estrade dÃ©corÃ©e sur laquelle on place un cerceuil
- AspÃ©ritÃ© : Partie saillante dâ€™une surface inÃ©gale
- CasÃ©eux : De la nature du fromage
- Miasme : Gaz putride provenant de susbtances en dÃ©composition
- Nonobstant : Sans Ãªtre empÃªchÃ© par (malgrÃ©)
- Ã‰culÃ© : UsÃ© / sans force Ã  cause dâ€™un trop grand usage
- Vareuse : Courte blouse de grosse toile pour marin
- Falot : Insignifiant, inconsistant, terne (câ€™est quand mÃªme bcp)
- Percale : MÃ©thode de tissage haut de gamme, donnant son nom au tissu
- Myrmidon : Personne de petite taille, insignifiante et prÃ©tentieuse (du grecque fourmi)
- Baguenauder : Familier de Â«Â flÃ¢nerÂ Â»
- Ã‰chalas : Pieu quâ€™on plante Ã  cÃ´tÃ© dâ€™un arbre pour le soutenir, par image : personne grande et maigre
- Aulique : Quelque chose qui appartient Ã  la cour dâ€™un suzerain
- Libation : Boire abondamment de lâ€™alcool
- Lippu : Qui a une grosse lÃ¨vre infÃ©rieure
- TavelÃ© : MarquÃ© de petites taches
- Ã‰tique : Dâ€™une extrÃªme maigreur
- ObsÃ©quieux : Qui exagÃ¨re la politesse par servilitÃ© ou hypocrisie
- Rotonde : Ã‰difice circulaire gÃ©nÃ©ralement surmontÃ© dâ€™une coupole
- Ponter : Jouer, miser de lâ€™argent
- Tartan : Motif de lignes horizontales et verticales entrecroisÃ©e, typique des peuples celte (motif Ã©cossais)
- Drille : Joyeux luron
- CaducÃ©e : BÃ¢ton entourÃ© de serpent, signe de la mÃ©decine
- ChaloupÃ© : OndulÃ© et rythmÃ© comme une chaloupe sur les vagues
- Chaloupe : Petit bateau Ã  rames
- Capricant : Qui se rapproche de la chÃ¨vre (sautillant, saccadÃ©)
- Julienne : ManiÃ¨re de tailler les lÃ©gumes en minces laniÃ¨res
- Commensaux : Personnes qui mangent habituellement Ã  la mÃªme table
- Coterie : Groupe restreint de personnes sâ€™entrenant dâ€™intÃ©rÃªts communs
- Lymphatique : Apathique, lent
- Ã‰migrant : Quelquâ€™un qui quitte son pays
- Immigrant : Quelquâ€™un qui rejoint un pays
- Galimatias : Discours embrouillÃ© et confus
- Goguenard : Qui affecte la moquerie
- Bavasser : Bavarder (familier / pÃ©joratif)
- Reptation : Action de ramper
- VillÃ©giature : SÃ©jour de repos, Ã  la campagne ou dans un lieu de plaisance
- Bigoterie : Manifester une dÃ©votion outrÃ©e et Ã©troite
- Sudation : Action de suer ou de faire suer (mÃ©decine)
- OblitÃ©rer : Effacer par une usure progressive
- GÃ©mellitÃ© : CaractÃ¨re de ce qui est jumeau
- UbiquitÃ© : CapacitÃ© a Ãªtre prÃ©sent en plusieurs lieux Ã  la fois
- AntÃ©pÃ©nultiÃ¨me : Qui vient avant lâ€™avant-dernier (lâ€™avant, avant dernier)
- HiÃ©ratique : Qui semble ritualisÃ©, cÃ©rÃ©monieux
- RÃ©manent : Qui subsiste aprÃ¨s la disparition de la cause
- EugÃ©nisme : Programme dâ€™amÃ©lioration de lâ€™espÃ¨ce humaine par sÃ©lection artificielle
- Transhumanisme : Mouvement visant Ã  dÃ©passer la condition humaine par lâ€™usage de la biologie et de lâ€™IA
- Formalisme : Mouvement artistique mettant lâ€™accent sur la forme plutÃ´t que sur le fond
- Subsumer : Ranger un cas spÃ©cifique sous un concept plus gÃ©nÃ©ral
- Solipsisme : ThÃ©orie philosophique selon laquelle il nâ€™y aurait pas dâ€™autre rÃ©alitÃ© pour le sujet pensant que lui-mÃªme. (Descartes joue un rÃ´le important dans sa constitution avec le cogito)
- Thanatophilique : Qui aime la mort (thanatos = mort en grec)
- Nihilisme : Doctrine prÃ´nant lâ€™absurditÃ© de la vie et donc lâ€™absurditÃ© de tous les essais des hommes pour y donner un sens (La Morale, les constructions sociales)
- Ã‰pigraphe : Courte citation placÃ©e au dÃ©but dâ€™un ouvrage pour en rÃ©sumer lâ€™esprit
- Cahot : Saut que faire une voiture en roulant sur une route inÃ©gale
- Veule : Qui manque dâ€™Ã©nergie, de courage et dâ€™entrain (du latin volus, Â«Â qui vole au vent)
- CinÃ©tique : Qui est en mouvement
- Coalescence : Union de parties qui sont normalement sÃ©parÃ©es
- SÃ©dation : Apaisement au moyen dâ€™un sÃ©datif
- Concupiscence : Envie des plaisirs interdits par la morale
- MÃ©phitique : Qui sent mauvais, qui est toxique
- IrrÃ©missible : Qui ne mÃ©rite pas la rÃ©mission (pardon)
- Discursif : Qui passe de quelque chose Ã  une autre par le raisonnement (o Ã  intuitif)
- ImprÃ©cation : Souhait de malheur contre quelquâ€™un
- Parapet : Mur Ã  hauteur dâ€™appui servant Ã  Ã©viter les chutes
- MÃ´le : Ouvrage construit Ã  lâ€™entrÃ©e dâ€™un port pour le protÃ©ger des vagues trop fortes (brise-lames)
- Munificence : Grandeur dans la gÃ©nÃ©rositÃ©
- Soubreveste : Veste sans manche
- Atermoyer : Reculer les termes dâ€™un paiement (par extension : diffÃ©rer quelque chose)
- Rachitisme : Maladie de la croissance et de lâ€™ossification observÃ©e chez le jeune enfant
- Rachitique : Par extension : malingre et chÃ©tif 
- Tour (masculin) : Machine oÃ¹ lâ€™on peut fixer une piÃ¨ce et la faire tourner sur elle-mÃªme pour la travailler
- Braiment (braire) : Cri de lâ€™Ã¢ne
- PÃ©ristyle : Colonnade entourant la cour intÃ©rieure ou la bordure extÃ©rieure dâ€™un bÃ¢timent 
- Circonvolution : Course elliptique ou circulaire autour dâ€™un centre (au figurÃ© : tourner autour du pot)
- Chevrier : Berger qui mÃ¨ne paÃ®tre les chÃ¨vres
- Fagot : Ensemble de bois menus reliÃ©s entre eux (souvent pour faire du feu)
- Vergue : Poutre de bois croisant le mÃ¢t pour soutenir la voile
- Sycomore : DÃ©signant initialement une espÃ¨ce de figuier, ce mot dÃ©signe aujourdâ€™hui aussi une espÃ¨ce dâ€™Ã©rable aux feuilles similaires
- Probe : Bon honnÃªte (du sanscrit prabhus, Â«Â MaÃ®tre, seigneurÂ Â»)
- InusitÃ© : Antonyme dâ€™usuel
- Haranguer : Discourir devant une assemblÃ©e ou une personne de haut rang
- Rameau : DerniÃ¨re ramification dâ€™une branche, petite branche
- Ramification : En botanique, processus de dÃ©veloppement des plantes et stratÃ©gie dâ€™exploitation des ressources extÃ©rieures. Au figurÃ© : synonyme dâ€™arborescence
- Arborescence : Organisation hiearchique des informations dont sa forme rappelle un arbre et ses branches. Forme ramifiÃ©e.
- Pampre : Rameau non-fructifÃ¨re (gourmand) de la vigne poussant sur sa base ou sur sa tÃªte.
- Gourmand : Branche secondaire dâ€™une plante, Ã©puisant et absorbant la sÃ¨ve de la branche principale.
- MÃ©taphore : DÃ©signer une chose par une autre, par ressemblance ou par partage dâ€™Ã©lÃ©ments essentiels.
- AllÃ©gorie : Narration mettant en oeuvre des Ã©lÃ©ments concrets pour parler dâ€™un contenu abstrait. (DÃ©crire une rose pour parler de lâ€™amour). Lâ€™allÃ©gorie part forcÃ©ment dâ€™une mÃ©taphore, mais devient allÃ©gorie lorsquâ€™elle est dÃ©veloppÃ© par une pluralitÃ© dâ€™Ã©lÃ©ments organisÃ©s dans une syntaxe.
- CatachrÃ¨se : MÃ©taphore si souvent utilisÃ©e quâ€™elle nâ€™est plus sentie comme telle. (Dâ€™oÃ¹ mon Ã©merveillement : le langage est plein de poÃ©sie !)
- Parabole : RÃ©cit allÃ©gorique illustrant une morale ou un enseignement.
- Parabole du riche et de Lazare : Un pauvre (Lazare) mendit un riche qui lâ€™ignore, les deux meurent, le pauvre ressucite tandis que le riche va au purgatoire. Le riche mendit alors la condition du pauvre mais Abraham le lui refuse. Le riche demande alors dâ€™envoyer Lazare pour prÃ©venir ses frÃ¨res. Mais Abraham refuse une fois encore en arguant que sâ€™ils nâ€™Ã©coutent pas MoÃ¯se, ce nâ€™est pas un mort rÃ©ssucitÃ© qui les convaincra.
- Lazzarone : Pauvre mais pas au sens pÃ©joratif, car ce mot tient son Ã©tymologie de Lazare, le pauvre rÃ©ssucitÃ© dans la parabole du riche et de Lazare.
- Treille : Vigne qui pousse autour ou contre un support (treillage, voÃ»te, murâ€¦)
- Treillage : Assemblage de lattes formant une paroi ajourÃ©e
- AjourÃ© : PercÃ©, ornÃ© de jours.
- Jours : Ouverture qui laisse passer la lumiÃ¨re.
- CaÃ¯que : Petit bateau dâ€™origine turque et grecque
- Barcarole : Chant des gondeliers vÃ©nitiens
- Numismatique : Ã‰tude des monnaies et des mÃ©dailles
- Carlin : Ancienne monnaie italienne
- Anse : Du latin ansa Â«Â poignÃ©eÂ Â», Â«Â priseÂ Â». Par analogie : forme recourbÃ©e.
- Esquif : Petite embarcation lÃ©gÃ¨re
- Rade : EntrÃ©e de mer dans la terre permettant un bon mouillage des bateaux
- Mouillage : Action de jeter lâ€™ancre
- Herse : De lâ€™arabe herth Â«Â labourÂ Â» (car introduit par les arabes). Câ€™est un instrument aratoire formÃ©e dâ€™une grille munie de grosses pointes. Peut aussi servir pour parler dâ€™un dispositif de barrage Ã  la forme analogue.
- Aratoire : Qui a rapport au labourage (du latin aratorius Â«Â de labourÂ Â»)
- GlÃ¨be : Terre quâ€™un serf exploitÃ© et auquelle il Ã©tait attachÃ© en sorte quâ€™on le vendait avec le fonds
- Quille : Partie la plus basse dâ€™un bateau (totalement immergÃ©)
- Harde : Troupeau de bÃªtes ou linge
- Capote : Grand manteau Ã  capuchon
- Nautonier : Celui qui conduit un bateau (du latin nauta Â«Â matelotÂ Â»)
- Convoyer : Accompagner, escorter. (Du latin conviare Â«Â faire route avec quelquâ€™unÂ Â»)
- Bas-latin : Version du latin parlÃ© vers la fin de lâ€™antiquitÃ© (III au VI aprÃ¨s JC)
- Mugissement (mugir) : Cri des bovins (meuuuuuh)
- Vendange : RÃ©colter des raisins pour faire du vin (du latin vindemia, vinum Â«Â vinÂ Â» + demere Â«Â prendreÂ Â»)
- Harasser : Fatiguer Ã  lâ€™excÃ¨s
- Bastion : Ouvrage de fortification faisant saillie sur lâ€™enceinte dâ€™une place forte
- Saillir : Jaillir, sortir, dÃ©border
- Ã€ faux : Ã  tort, injustement, de travers
- Ciseau : Outil dâ€™acier, pointu et aiguisÃ©, servant Ã  travailler des matiÃ¨res dures
- Cellier : Lieu dans lequel on range le vin et les provisions
- Plein cintre : Figure en arc de cercle dont le trait est un demi-cercle parfait
- SurhaussÃ© : Figure en arc de cercle dont la hauteur est supÃ©rieur Ã  la moitiÃ© de la largeur
- SurbaissÃ© : Figure en arc de cercle dont la hauteur est infÃ©rieur Ã  la moitiÃ© de la largeur
- Arc outrepassÃ© : Arc dont le diamÃ¨tre est plus large que lâ€™espace entre les piliers qui le soutiennent
-  Vestibule : PremiÃ¨re piÃ¨ce dâ€™un batiment, et qui sert de passage vers lers autres piÃ¨ces
- Plain-pied : Espace de mÃªme niveau, sans marche.
- Candeur : Blancheur, puretÃ©. Du latin candor Â«Â blancÂ Â». 
- Ã‰cheveau : Assemblage de fils repliÃ©s sur eux-mÃªmes afin quâ€™ils ne se mÃªlent pas.
- Flocon : Petite touffe, amas lÃ©ger.
- Quenouille : Instrument ancien utilisÃ© pour le filage des matiÃ¨res textiles.
- Solive : PiÃ¨ce de charpente soutenant le plancher et qui porte sur les murs ou les poutres
- BÃ¢t : Selle que lâ€™on place sur le dos des bÃªtes de somme pour le transport de leur charge
- Bruisser : Produire un petit bruit indistinct
- SÃ©ant : Cul
- Radouber : RÃ©parer la coque dâ€™un navire
- Brick : Type de voilier
- Piastre : Nom commun de diffÃ©rentes monnaies
- Sequin : Ancienne monnaie dâ€™or de Venise
- Ã‰quarrir : Tailler pour rendre carrÃ©, rÃ©gulier
- Fruste : Dont le relief a Ã©tÃ© effacÃ© par lâ€™usure
- Arrimer : Charger et arranger avec soliditÃ© une cargaison Ã  lâ€™intÃ©rieur dâ€™un bÃ¢timent 
- Muscat : CÃ©page trÃ¨s parfumÃ© rappelant le musc
- MÃ©tairie : Petite ferme dont le fermier paie une redevance annuelle en argent ou en rÃ©colte
- DÃ©pression : Enfoncement, abaissement.
- PathÃ©tique : Qui Ã©meut (du grec ancien pÃ thos Â«Â Ãªtre affectÃ©Â Â»)
- Pathos : Ton pathÃ©tique excessif dans un discours ou un Ã©crit (ils ont un peu retournÃ© le sens originel)
- ArriÃ©rÃ© : Qui est en retard
- Fiasque : Bouteille clissÃ©e Ã  col long et Ã  panse rebondie
- Clisse : Tissage dâ€™osier servant Ã  protÃ©ger les verres et les bouteilles
- Vannerie : Lâ€™art de tresser les fibres vÃ©gÃ©tales
- Contrefait : Qui est difforme (en plus du sens habituel de contrefaÃ§on)
- Rouet : Machine Ã  roue mue par une pÃ©dale et servant Ã  filer
- Ã‰xÃ¨gese : Explication, commentaire, interprÃ©tation dâ€™un texte ancien et compliquÃ©
- CoÃ¯t : Union sexuelle
- Nimbe : Halo ou flou qui entoure une personne ou une chose (ex : aurÃ©ole)
- HÃ¨ler : Appeler de loin
- Racisme : IdÃ©ologie postulant une hierarchie des races
- XÃ©nophobie : Peur de lâ€™Ã©tranger et de ce qui en provient (xÃ©nos -> Ã©tranger, phobos -> peur)
- DÃ©cati : Ã‰prouvÃ© par lâ€™Ã¢ge, qui a perdu sa fraÃ®cheur
- Apoplexie : ArrÃªte brutal du cerveau entraÃ®nant perte partielle ou complÃ¨te du mouvement ou de la connaissance
- Dru : En grande quantitÃ© et serrÃ©
- Antienne : Refrain liturgique repris par le chÅ“ur entre chaque verset dâ€™un psaume (refrain, sloganâ€¦)
- Ã‰quanime : Dont lâ€™Ã¢me reste Ã©gale, constante (toujours positif par exemple)
- Adret : Versant de la montagne exposÃ©e au sud, donc au soleil
- Ubac : Versant de la montagne exposÃ©e au nord, donc Ã  lâ€™ombre
- InconsÃ©quence : Manque de suite dans les idÃ©es, de rÃ©flexion dans la conduite
- Simiesque : Qui tient du singe
- DÃ©miurge : DivinitÃ© crÃ©atrice dâ€™un monde
- Labial : Relatif aux lÃ¨vres
- Acception : Sens particulier dâ€™un mot (synonyme de signification)
- Jure divino : Par loi divine
- Diligence : RapiditÃ© dans lâ€™exÃ©cution dâ€™une chose
- Marotte : Sceptre du fou
- Similis simili gaudet : Qui se ressemble sâ€™assemble
- Habes, habeberis : Tu as, tu auras
- Ostracisme : Rejet hostile, par une collectivitÃ©, dâ€™un de ses membres
- Ordalie : Jugement de Dieu sous la forme dâ€™Ã©preuve (par le feu, lâ€™eauâ€¦)
- Ã‰minence grise : Conseiller influent, exerÃ§ant son pouvoir dans lâ€™ombre
- Entropie : DegrÃ© de dÃ©sordre, dâ€™incertitude dâ€™un systÃ¨me
- Contention : Tension forte et prolongÃ©e des facultÃ©s intellectuelles
- Systole : Quand le coeur se contracte
- Diastole : Quand le coeur se dilate
- Antagonisme : Ã‰tat dâ€™opposition entre deux forces, deux principes.
- ImpÃ©tueux : Dont lâ€™impulsion est violente et rapide
- PrÃ©gnant : Qui sâ€™impose Ã  lâ€™esprit, particuliÃ¨rement expressif par rapport au reste
- Morganatique : Union entre une personne de rang supÃ©rieur et une personne de rang infÃ©rieur (ne confÃ¨re pas les mÃªmes droits quâ€™un mariage classique)
- Anthropophagie : Consommer de la chaire humaine
- Cannibalisme : Consommer un individu de sa propre espÃ¨ce (plus gÃ©nÃ©ral quâ€™anthropophage)
- ParÃ©nÃ¨se : Discours moral, exhortation Ã  la vertu
- Apologue : Petit rÃ©cit visant Ã  illustrer une leÃ§on morale
- IniquitÃ© : Injustice extrÃªme (contraire dâ€™Ã©quitÃ©)
- HiÃ©ratique : En rapport avec le formalisme religieux
- Ablution : Purification rituelle dâ€™une partie du corps avant un acte religieu
- âˆ (Proportionnel Ã ) : En MathÃ©matiques le symbole Â«Â âˆÂ Â» indique un rapport de proportionnalitÃ© entre les deux membres de lâ€™Ã©quation (si lâ€™un augmente lâ€™autre aussi et inversement), cependant sans nous en donner le coefficient
- AmÃ©nitÃ© : AmabilitÃ© pleine de charme
- Septentrional : Du cÃ´tÃ© du nord (gÃ©ographie)
- Lithographie : Technique dâ€™impression et de reproduction par tracÃ© dâ€™un crayon sur une pierre calcaire
- HomÃ©lie : Discours expliquant texte religieux
- MÃ©plat : Surface plane ayant plus de largeur que dâ€™Ã©paisseur
- Chaume : Tige dâ€™une plante
- Ã‰teule : Chaume laissÃ© sur place aprÃ¨s la moisson
- Combe : DÃ©pression, vallÃ©e profonde
- Cosse : Enveloppe de la graine
- Bardeau : Type de tuile
- Galetas : Logement pratiquÃ© sous les combles (par extension : sordide, misÃ©rable)
- Courtepointe : Couverture de lit
- Ã‰piphanie : ComprÃ©hension soudaine de lâ€™essence ou de la signification de quelque chose
- CroisÃ©e : FenÃªtre en forme de croix
- Madrier : Poutre Ã©paisse
- Roturier : Qui nâ€™est pas noble
- Noblesse de cloche : Roturier anoblit pour lâ€™exercice de fonction administrative et municipales
- Ã‰chevin : Jusquâ€™Ã  la RÃ©volution, magistrat municipal
- Pan : Partie plane dâ€™un mur
- Hourdage : MaÃ§onnerie grossiÃ¨re
- Rabot : Outil du menuisier pour aplanir le bois
- Ouvroir : UtilisÃ© au Moyen-Age pour parler dâ€™un lieu de travail
- Merrain : Bois de chÃªne dÃ©bite en fines planches
- Closerie : Petite exploitation agricole dÃ©tenue en propre (par opposition Ã  la mÃ©tairie)
- Gausser : Se moquer de quelquâ€™un
- Ci-devant : Ancien. En particulier, les nobles dÃ©chus par la RÃ©volution
- CadastrÃ© : OpÃ©ration consistant Ã  dÃ©terminer lâ€™Ã©tendue et la valeur des biens-fonds
- Biens-fonds : Biens immeubles
- Immeuble : Qui ne peut Ãªtre dÃ©placÃ© (Droit)
- ProdigalitÃ©s : DÃ©penses excessives
- Boston : Jeu de carte inventÃ© Ã  Boston au XVIII 
- Truisse : Vieux tronc dâ€™arbres, bouquet dâ€™arbres taillÃ©s en tÃªtard
- Ã‰tamage : Action de dÃ©poser une couche dâ€™Ã©tain sur une piÃ¨ce mÃ©tallique pour la prÃ©server de lâ€™oxydation
- ProbitÃ© : HonnÃªte scrupuleuse
- Pazzi : Famille noble de Florence, principale rivale des MÃ©dicis
- Doloire : Petite hache de tonnelier
- RÃ©aliser ses capitaux : Convertir ses actifs financier en argent liquide
- Payer sous escompte : RÃ©duction du prix si payÃ© avant date convenue
- Tuffeau : Roche poreuse, Ã  la fois lÃ©gÃ¨re et solide
- Jambages : Montants verticaux supportant lâ€™arc de la porte
- VermiculÃ© : OrnÃ© de petites stries sinueuses
- Plinthe : Bande plate courant au pied dâ€™un bÃ¢timent ou dâ€™un mur
- Porte cochÃ¨re : Porte suffisamment grande pour laisser passer les cochers
- Manteau de cheminÃ©e : Meuble en U inversÃ© habillant une cheminÃ©e
- Damasquiner : Incruster pour orner un mÃ©tal de petits filets dâ€™or ou dâ€™argent
- Girandole : Chandelier Ã  plusieurs branches disposÃ©es en pyramide
- BobÃ¨che : TÃªte dâ€™un chandelier, contenant la bougie, destinÃ© Ã  recueillir la cire
- Encoignure : Angle entre deux murs, dÃ©signe aussi un petit meuble de coin
- Marqueterie : Assemblage dÃ©coratif de bois prÃ©cieux
- Glaner : Ramasser des Ã©pis de blÃ© aprÃ¨s la moisson, ramasser les miettes
- Halleboteur : Glaneur dans les vignes
- Alberge : Fruit entre la pÃªche et lâ€™abricot
- Bouge : Logement obscur et malpropre
- Fichu : Triangle dâ€™Ã©toffe dont les femmes se couvraient la tÃªte et les Ã©paules
- Vermoulu : Bois rongÃ© par les vers
- Ã‰cumoire : Large cuillÃ¨re criblÃ©e de trous
- Claustral : Relatif au cloÃ®tre
- Vermeil : Rouge vif
- Tabac Ã  priser : Tabac en poudre quâ€™on sniffait
- ColimaÃ§on : Escargot
- Roupie : Goutte qui tombe du nez
- SÃ©nile : Relatif Ã  la vieillesse
- Racorni : Durci comme de la corne
- Lorgnon : Monocle Ã  monture
- Sourdre : Sortir de terre (en parlant de lâ€™eau)
- Keepsake : Livre-album illustrÃ© quâ€™on offrait Ã  lâ€™Ã©poque romantique
- VÃ©lin : Papier plus lisse et plus fin que le parchemin
- Obvier : Prendre les dispositions nÃ©cessaires pour faire obstacle Ã  quelque chose
- Grigou : Avare (familier)
- Provin : Rejeton dâ€™une plante provignÃ©e
- Mirliflore : Jeune Ã©lÃ©gant prÃ©tentieux
- Juchoir : Perchoir des oiseaux de basse-cour
- Chambranle : Encadrement dÃ©coratif de pierre ou de bois autour dâ€™une ouverture
- Margelle : Rebord dâ€™un puit, dâ€™un bassin oÃ¹ dâ€™une piscine
- Broui : Qualifie une plante frappÃ©e par le gel
- Ergot : Chez les coqs, pointe recourbÃ©e du talon servant dâ€™arme offensive
- Mouillette : Petit morceau de pain quâ€™on trempe dans un liquide
- Grisette : Jeune fille coquette de modeste condition
- Ilote : Habitant de la Laconie rÃ©duit en esclavage par les Spartiates
- Embucquer : Gaver
- Captieux : Qui vise Ã  tromper par des apparences de raison
- Neuvaine : Exercice de piÃ©tÃ© quâ€™on rÃ©pÃ¨te pendant 9 jours consÃ©cutifs pour pour obtenir une grÃ¢ce particuliÃ¨re
- MÃ©lÃ¨ze : EspÃ¨ce dâ€™arbre (Â«Â Pin de brianÃ§onÂ Â»)
- MÃ¢tinÃ© : Issu du croisement dâ€™un animal de race avec un animal dâ€™une autre race
- CÃ©lÃ©ritÃ© : Promptitude dans lâ€™exÃ©cution
- MansuÃ©tude : Disposition dâ€™Ã¢me qui porte Ã  Ãªtre clÃ©ment, patient, indulgent
- Muser : Comme Â«Â flÃ¢nerÂ Â» mais avec une connotation plus vaine
- Ourdir : PrÃ©parer un ourdissoir en vue dâ€™un tissage (Au figurÃ©, tramer)
- CÃ©ramique : Famille de matÃ©riaux inorganiques, non mÃ©talliques, souvent Ã  base dâ€™argile, durcis par la chaleur
- FaÃ¯ence : Type de cÃ©ramique originaire de la ville de Faenza en Italie
- Meunier : Personne possÃ©dant ou exploitant un moulin
- Se repentir : Ressentir un vif regret dâ€™une faute accompagnÃ© dâ€™un dÃ©sir de rÃ©paration
- Faire pÃ©nitence : Se repentir
- CarÃªme : PÃ©riode de 40 jours oÃ¹ les chrÃ©tiens jeÃ»nent, prient et se repentissent et qui prÃ©cÃ¨de la cÃ©lÃ©bration de PÃ¢ques
- Expiation : Processus de rÃ©paration ou de compensation pour une faute ou un pÃ©chÃ©
- Ambages : DÃ©tours dans les paroles tÃ©moignant de lâ€™embarras de lâ€™interlocuteur
- DÃ©confiture : DÃ©faite complÃ¨te
- Absoudre : Permettre Ã  un coupable dâ€™Ã©chapper Ã  toute mesure rÃ©pressive
- Faillite : Terme gÃ©nÃ©rique donnÃ© Ã  lâ€™impossibilitÃ© dâ€™une personne morale ou physique de faire face Ã  ces dettes. ConfÃ¨re certains droits comme la cessation de paiement, le surendettementâ€¦
- Liquidation : Vente des actifs et cessation de lâ€™activitÃ©
- Hoirie : HÃ©ritage (Vieux)
- Ã‚cre : Quelque chose de piquant ou irritant
- Ã‚pre : Qui par son Ã¢cretÃ© ou sa rudesse provoque une sensation dÃ©sagrÃ©able